1111111111111
10010C0001101
100000E001001
1011000110101
10110C1001101
10110C0P01101
10110C1001101
1111111111111