1111111111111
1100PC0000001
11000C0000001
11000C0000001
11E000C000001
1111111111111