1111111111111
1P010C0011101
1000000E01101
1011000001101
10110C1001101
10110C1001101
10110C1001101
1111111111111